*******************************
*S    *     *     *           *
****  **********  *  *******  *
*  *  *              *        *
****  *  *  *******  *  *  *  *
*  *     *  *     *  *  *  *  *
**********  ****  *  ****  ****
*     *    **  *  *  *     *  *
******** ****  *  **********  *
*        *                    *
*  **********  *  **********  *
*     *        *           *  *
*  ****  *  ****  *  *******  *
*        *  *  *  *  *     *  *
**********  *******  *  ****  *
*        *        *        *  *
****************  *************
*  *     *     *           * E*
*  ****  ****  **********  *  *
*                       *     *
*******************************